F 29,206,195
C 64,64,64

NO ./images/wall1.png
SO ./images/wall2.png
WE ./images/wall3.png
EA ./images/wall4.png
DO ./images/door.png

111111111111111111111111
1000000N0000000000000001
100000000000000000000001
100000000000000000000001
100000000000000000000001
111111111111111111111111
