

NO ./images/wall1.png

F 29,206,195

SO ./images/wall2.png

DO ./images/new_door.png


WE ./images/wall3.png

EA ./images/wall4.png

C    64,64,64

111111111111111111111111
100001000001000000000001
100003000000000000000001
100001000001000000000001
111111131111111111311111
100000000000010000000001
100000000000010000000001
100000000000010000000001
111111131111111111311111
100000000000000000000001
100100000000010000000001
100100000000010000000001
111111121111111111311111
100000000000000000000001
100000000044000000000001
100000000N00000000000001
100000100000000000040001
100000300000000000000001
100000113100000000000001
100000000000000000000401
100000004000000000000001
111111111111111111111111
