NO ./images/bluestone.png
SO ./images/bluestone.png
WE ./images/bluestone.png
EA ./images/bluestone.png
DO ./images/new_door.png

F 64,64,64
C 64,64,64

1111111111111111111
1000010000010000001
1000010000010000001
1000010000010000001
1000010000010000001
1000010000010000001
1000010000010000001
1111111131111111111
1000010000010000001
1000030040030000001
1000010000010000001
1111110000011111111
1000010000010000001
10E0030040030000001
1000010000010000001
1111110000011111111
1000000000000000001
1004000040000004001
1000000000000000001
1111111111111111111
