NO ./images/bluestone.png
SO ./images/bluestone.png
WE ./images/bluestone.png
EA ./images/bluestone.png
DO ./images/new_door.png

F 64,64,64
C 64,64,64

1111111111111111111111111
1000000000001000000000001
1000000000701000000000001
1000007000003000000000001
1000000000001000000000001
1000000000001000000000001
1111113111111111111111111
    10501
    10001
    10001
    10001
    10001
    10001
    10501
    10001
    10001
    10701
    10001
    10001
    10501
1111113111111
1000100010001
1000305030001
1000100010001
1111100011111
1000100010001
10E0305030601
1000100010001
1111100011111
1065005005041
1600000000041
1111111111111
