NO ./images/bluestone.png
SO ./images/bluestone.png
WE ./images/bluestone.png
EA ./images/bluestone.png
DO ./images/new_door.png

F 64,64,64
C 64,64,64

1111111111111111111111111
1000000000001000000000001
1000000000001000000000001
1000000000003000000000001
1000000000001000000000001
1000000000001000000000001
1111113111111111111111111
    10401
    10001
    10001
    10001
    10001
    10001
    10401
    10001
    10001
    10001
    10001
    10001
    10401
1111113111111
1000100010001
1000304030001
1000100010001
1111100011111
1000100010001
10E0304030001
1000100010001
1111100011111
1004004004001
1000000000001
1111111111111
